1111111111111111111111111111
1111111111122222211111111111
1111111111221111221111111111
1111111112211111122111111111
1111111112111111112111111111
1111111112111111112111111111
1111111112111111112111111111
1111111112111111112111111111
1111111112111111112111111111
1111111112111111112111111111
1111111112111111112111111111
1111111112111111112111111111
1111111112111111112111111111
1111111112111111112111111111
1111111112111111112111111111
1111111112111111112111111111
1111111112111111112111111111
1111111112111111112111111111
1111111112111111112111111111
1111111112111111112111111111
1111111112111111112111111111
1222222222222222222222222221
1211111112111111112111111121
1211111112111111112111111121
1211111112111111112111111121
1211111112111111112111111121
1211111112111111112111111121
1211111112111111112111111121
1211111112111111112111111121
1222222222111111112222222221
1111111111111111111111111111